TopicMF: Simultaneously Exploiting Ratings and Reviews for Recommendation	Yang Bao, Hui Fang, Jie Zhang
Context-Aware Collaborative Topic Regression with Social Matrix Factorization for Recommender Systems	Chaochao Chen, Xiaolin Zheng, Yan Wang, Fuxing Hong, Zhen Lin
Improving Context and Category Matching for Entity Search	Yueguo Chen, Lexi Gao, Shuming Shi, Xiaoyong Du, Ji-Rong Wen
Machine Translation with Real-Time Web Search	Lei Cui, Ming Zhou, Qiming Chen, Dongdong Zhang, Mu Li
Leveraging Decomposed Trust in Probabilistic Matrix Factorization for Effective Recommendation	Hui Fang, Yang Bao, Jie Zhang
Influence Maximization with Novelty Decay in Social Networks	Shanshan Feng, Xuefeng Chen, Gao Cong, Yifeng Zeng, Yeow Meng Chee, Yanping Xiang
CoreCluster: A Degeneracy Based Graph Clustering Framework	Christos Giatsidis, Fragkiskos Malliaros, Dimitrios Thilikos, Michalis Vazirgiannis
Experiments on Visual Information Extraction with the Faces of Wikipedia	Md. Kamrul Hasan, Christopher Joseph Pal
Online Social Spammer Detection	Xia Hu, Jiliang Tang, Huan Liu
User Group Oriented Temporal Dynamics Exploration	Zhiting Hu, Junjie Yao, Bin Cui
Predicting Emotions in User-Generated Videos	Yu-Gang Jiang, Baohan Xu, Xiangyang Xue
How Long Will It Take? Accurate Prediction of Ontology Reasoning Performance	Yong-Bin Kang, Jeff Z. Pan, Shonali Krishnaswamy, Wudhichart Sawangphol, Yuan-Fang Li
Towards Scalable Exploration of Diagnoses in an Ontology Stream	Freddy Lecue
ARIA: Asymmetry Resistant Instance Alignment	Sanghoon Lee, Seung-won Hwang
Learning Parametric Models for Social Infectivity in Multi-Dimensional Hawkes Processes	Liangda Li, Hongyuan Zha
Fraudulent Support Telephone Number Identification Based on Co-Occurrence Information on the Web	Xin Li, Yiqun Liu, Min Zhang, Shaoping Ma
Compact Aspect Embedding for Diversified Query Expansions	Xiaohua Liu, Arbi Bouchoucha, Alessandro Sordoni, Jian-Yun Nie
Source Free Transfer Learning for Text Classification	Zhongqi Lu, Yin Zhu, Sinno Jialin Pan, Evan Wei Xiang, Yujing Wang, Qiang Yang
Parallel Materialisation of Datalog Programs in Centralised, Main-Memory RDF Systems	Boris Motik, Yavor Nenov, Robert Piro, Ian Horrocks, Dan Olteanu
Fast and Accurate Influence Maximization on Large Networks with Pruned Monte-Carlo Simulations	Naoto Ohsaka, Takuya Akiba, Yuichi Yoshida, Ken-ichi Kawarabayashi
Combining Heterogenous Social and Geographical Information for Event Recommendation	Zhi Qiao, Peng Zhang, Yanan Cao, Chuan Zhou, Li Guo, Binxing Fang
Stochastic Privacy	Adish Singla, Eric Horvitz, Ece Kamar, Ryen White
Mapping Users across Networks by Manifold Alignment on Hypergraph	Shulong Tan, Ziyu Guan, Deng Cai, Xuzhen Qin, Jiajun Bu, Chun Chen
Acquiring Comparative Commonsense Knowledge from the Web	Niket Tandon, Gerard de Melo, Gerhard Weikum
Who Also Likes It? Generating the Most Persuasive Social Explanations in Recommender Systems	Beidou Wang, Martin Ester, Jiajun Bu, Deng Cai
Cross-Lingual Knowledge Validation Based Taxonomy Derivation from Heterogeneous Online Wikis	Zhigang Wang, Juanzi Li, Shuangjie Li, Mingyang Li, Jie Tang, Kuo Zhang, Kun Zhang
Emotion Classification in Microblog Texts Using Class Sequential Rules	Shiyang Wen, Xiaojun Wan
Quality-Based Learning for Web Data Classification	Ou Wu, Ruiguang Hu, Xue Mao, Weiming Hu
Cross-View Feature Learning for Scalable Social Image Analysis	Wenxuan Xie, Yuxin Peng, Jianguo Xiao
Capturing Difficulty Expressions in Student Online Q&A Discussions	Jaebong Yoo, Jihie Kim
A Joint Optimization Model for Image Summarization Based on Image Content and Tags	Hongliang Yu, Zhi-Hong Deng, Yunlun Yang, Tao Xiong
Recommendation by Mining Multiple User Behaviors with Group Sparsity	Ting Yuan, Jian Cheng, Xi Zhang, Shuang Qiu, Hanqing Lu
Learning Temporal Dynamics of Behavior Propagation in Social Networks	Jun Zhang, Chaokun Wang, Jianmin Wang
Trust Prediction with Propagation and Similarity Regularization	Xiaoming Zheng, Yan Wang, Mehmet A. Orgun, Youliang Zhong, Guanfeng Liu
Synthesis of Geometry Proof Problems	Chris Alvin, Sumit Gulwani, Rupak Majumdar, Supratik Mukhopadhyay
GenEth: A General Ethical Dilemma Analyzer	Michael Anderson, Susan Leigh Anderson
Huffman Coding for Storing Non-Uniformly Distributed Messages in Networks of Neural Cliques	Bartosz Boguslawski, Vincent Gripon, Fabrice Seguin, Frédéric Heitzmann
Where and Why Users "Check In"	Yoon-Sik Cho, Greg Ver Steeg, Aram Galstyan
A Machine Learning Approach to Musically Meaningful Homogeneous Style Classification	William Herlands, Ricky Der, Yoel Greenberg, Simon Levin
Programming by Example Using Least General Generalizations	Mohammad Raza, Sumit Gulwani, Natasa Milic-Frayling
Modeling and Predicting Popularity Dynamics via Reinforced Poisson Processes	Huawei Shen, Dashun Wang, Chaoming Song, Albert-László Barabási
Joule Counting Correction for Electric Vehicles Using Artificial Neural Networks	Michael David Taylor
How Do Your Friends on Social Media Disclose Your Emotions?	Yang Yang, Jia Jia, Shumei Zhang, Boya Wu, Qicong Chen, Juanzi Li, Chunxiao Xing, Jie Tang
Forecasting Potential Diabetes Complications	Yang Yang, Walter Luyten, Lu Liu, Marie-Francine Moens, Jie Tang, Juanzi Li
k-CoRating: Filling Up Data to Obtain Privacy and Utility	Feng Zhang, Victor E. Lee, Ruoming Jin
Modeling Subjective Experience-Based Learning under Uncertainty and Frames	Hyung-il Ahn, Rosalind Picard
The Importance of Cognition and Affect for Artificially Intelligent Decision Makers	Celso M. de Melo, Jonathan Gratch, Peter J. Carnevale
Efficient Codes for Inverse Dynamics During Walking	Leif Johnson, Dana H Ballard
An Agent-Based Model Studying the Acquisition of a Language System of Logical Constructions	Josefina Sierra-Santibanez
Large-Scale Analogical Reasoning	Vinay K. Chaudhri, Stijn J. Heymans, Adam Overholtzer, Aaron Spaulding, Michael Wessel
Learning Compositional Sparse Models of Bimodal Percepts	Suren Kumar, Vikas Dhiman, Jason J. Corso
Using Narrative Function to Extract Qualitative Information from Natural Language Texts	Clifton James McFate, Kenneth Forbus, Thomas Hinrichs
Confident Reasoning on Raven's Progressive Matrices Tests	Keith McGreggor, Ashok Goel
Learning Goal-Oriented Hierarchical Tasks from Situated Interactive Instruction	Shiwali Mohan, John Laird
Learning Unknown Event Models	Matthew Molineaux, David W. Aha
Social Planning: Achieving Goals by Altering Others' Mental States	Chris Pearce, Ben Meadows, Pat Langley, Mike Barley
Spatio-Temporal Consistency as a Means to Identify Unlabeled Objects in a Continuous Data Field	James Faghmous, Hung Nguyen, Matthew Le, Vipin Kumar
Placement of Loading Stations for Electric Vehicles: No Detours Necessary!	Stefan Ernst Funke, Andre Nusser, Sabine Storandt
A Region-Based Model for Estimating Urban Air Pollution	Arnaud Jutzeler, Jason Jingshi Li, Boi Faltings
Spatial Scan for Disease Mapping on a Mobile Population	Liang Lan, Vuk Malbasa, Slobodan Vucetic
Challenges in Materials Discovery — Synthetic Generator and Real Datasets	Ronan Le Bras, Richard Bernstein, John M Gregoire, Santosh K Suram, Carla P Gomes, Bart Selman, R. Bruce van Dover
Supervised Scoring with Monotone Multidimensional Splines	Abraham Othman
Efficient Buyer Groups for Prediction-of-Use Electricity Tariffs	Valentin Robu, Meritxell Vinyals, Alex Rogers, Nicholas R. Jennings
Intelligent System for Urban Emergency Management during Large-Scale Disaster	Xuan Song, Quanshi Zhang, Yoshihide Sekimoto, Ryosuke Shibasaki
TacTex'13: A Champion Adaptive Power Trading Agent	Daniel Urieli, Peter Stone
Effective Management of Electric Vehicle Storage Using Smart Charging	Konstantina Valogianni, Wolfgang Ketter, John Collins, Dmitry Zhdanov
Rounded Dynamic Programming for Tree-Structured Stochastic Network Design	Xiaojian Wu, Daniel Sheldon, Shlomo Zilberstein
Contextually Supervised Source Separation with Application to Energy Disaggregation	Matt Wytock, J. Zico Kolter
Modeling and Mining Spatiotemporal Patterns of Infection Risk from Heterogeneous Data for Active Surveillance Planning	Bo Yang, Hua Guo, Yi Yang, Benyun Shi, Xiaonong Zhou, Jiming Liu
A Latent Variable Model for Discovering Bird Species Commonly Misidentified by Citizen Scientists	Jun Yu, Rebecca A. Hutchinson, Weng-Keen Wong
Approximate Equilibrium and Incentivizing Social Coordination	Elliot Anshelevich, Shreyas Sekar
Solving the Inferential Frame Problem in the General Game Description Language	Javier Romero Davila, Abdallah Saffidine, Michael Thielscher
Generating Content for Scenario-Based Serious-Games Using CrowdSourcing	Sigal Sina, Avi Rosenfeld, Sarit Kraus
Automatic Game Design via Mechanic Generation	Alexander Zook, Mark O. Riedl
False-Name Bidding and Economic Efficiency in Combinatorial Auctions	Colleen Alkalay-Houlihan, Adrian Vetta
On the Incompatibility of Efficiency and Strategyproofness in Randomized Social Choice	Haris Aziz, Florian Brandl, Felix Brandt
Fixing a Balanced Knockout Tournament	Haris Aziz, Serge Gaspers, Simon Mackenzie, Nicholas Mattei, Paul Stursberg, Toby Walsh
A Generalization of Probabilistic Serial to Randomized Social Choice	Haris Aziz, Paul Stursberg
Simultaneous Cake Cutting	Eric Balkanski, Simina Brânzei, David Kurokawa, Ariel D. Procaccia
Lazy Defenders Are Almost Optimal against Diligent Attackers	Avrim Blum, Nika Haghtalab, Ariel D. Procaccia
Extending Tournament Solutions	Felix Brandt, Markus Brill, Paul Harrenstein
The Fisher Market Game: Equilibrium and Welfare	Simina Brânzei, Yiling Chen, Xiaotie Deng, Aris Filos-Ratsikas, Søren Kristoffer Stiil Frederiksen, Jie Zhang
Regret Transfer and Parameter Optimization	Noam Brown, Tuomas Sandholm
Solving Imperfect Information Games Using Decomposition	Neil Burch, Michael Johanson, Michael Bowling
Biased Games	Ioannis Caragiannis, David Kurokawa, Ariel D. Procaccia
Modal Ranking: A Uniquely Robust Voting Rule	Ioannis Caragiannis, Ariel D. Procaccia, Nisarg Shah
Mechanism Design for Scheduling with Uncertain Execution Time	Vincent Conitzer, Angelina Vidali
Using Response Functions to Measure Strategy Strength	Trevor Davis, Neil Burch, Michael Bowling
New Models for Competitive Contagion	Moez Draief, Hoda Heidari, Michael Kearns
Preference Elicitation and Interview Minimization in Stable Matchings	Joanna Drummond, Craig Boutilier
A Characterization of the Single-Peaked Single-Crossing Domain	Edith Elkind, Piotr Faliszewski, Piotr Skowron
On Detecting Nearly Structured Preference Profiles	Edith Elkind, Martin Lackner
Binary Aggregation by Selection of the Most Representative Voters	Ulle Endriss, Umberto Grandi
On the Axiomatic Characterization of Runoff Voting Rules	Rupert Freeman, Markus Brill, Vincent Conitzer
Potential-Aware Imperfect-Recall Abstraction with Earth Mover's Distance in Imperfect-Information Games	Sam Ganzfried, Tuomas Sandholm
Mechanism Design for Mobile Geo-Location Advertising	Nicola Gatti, Marco Rocco, Sofia Ceppi, Enrico H. Gerding
Voting with Rank Dependent Scoring Rules	Judy Goldsmith, Jérôme Lang, Nicholas Mattei, Patrice Perny
Increasing VCG Revenue by Decreasing the Quality of Items	Mingyu Guo, Argyrios Deligkas, Rahul Savani
A Control Dichotomy for Pure Scoring Rules	Edith Hemaspaandra, Lane A. Hemaspaandra, Henning Schnoor
A Multiarmed Bandit Incentive Mechanism for Crowdsourcing Demand Response in Smart Grids	Shweta Jain, Balakrishnan Narayanaswamy, Y. Narahari
Envy-Free Division of Sellable Goods	Jeremy Karp, Aleksandr M. Kazachkov, Ariel D. Procaccia
Betting Strategies, Market Selection, and the Wisdom of Crowds	Willemien Kets, David M. Pennock, Rajiv Sethi, Nisarg Shah
Incomplete Preferences in Single-Peaked Electorates	Martin Lackner
Item Bidding for Combinatorial Public Projects	Evangelos Markakis, Orestis Telelis
Regret-Based Optimization and Preference Elicitation for Stackelberg Security Games with Uncertainty	Thanh Hong Nguyen, Amulya Yadav, Bo An, Milind Tambe, Craig Boutilier
On the Structure of Synergies in Cooperative Games	Ariel D. Procaccia, Nisarg Shah, Max Lee Tucker
Incentives for Truthful Information Elicitation of Continuous Signals	Goran Radanovic, Boi Faltings
Equilibria in Epidemic Containment Games	Sudip Saha, Abhijin Adiga, Anil Kumar S. Vullikanti
Bounding the Support Size in Extensive Form Games with Imperfect Information	Martin Schmid, Matej Moravcik, Milan Hladik
Two Case Studies for Trading Multiple Indivisible Goods with Indifferences	Akihisa Sonoda, Etsushi Fujita, Taiki Todo, Makoto Yokoo
Beat the Cheater: Computing Game-Theoretic Strategies for When to Kick a Gambler out of a Casino	Troels Bjerre Sørensen, Melissa Dalis, Joshua Letchford, Dmytro Korzhyk, Vincent Conitzer
Strategyproof Exchange with Multiple Private Endowments	Taiki Todo, Haixin Sun, Makoto Yokoo
A Strategy-Proof Online Auction with Time Discounting Values	Fan Wu, Junming Liu, Zhenzhe Zheng, Guihai Chen
Incentivizing High-Quality Content from Heterogeneous Users: On the Existence of Nash Equilibrium	Yingce Xia, Tao Qin, Nenghai Yu, Tie-Yan Liu
Game-Theoretic Resource Allocation for Protecting Large Public Events	Yue Yin, Bo An, Manish Jain
Relaxation Search: A Simple Way of Managing Optional Clauses	Fahiem Bacchus, Jessica Davies, Maria Tsimpoukelli, George Katsirelos
Parallel Restarted Search	Andre Cire, Serdar Kadioglu, Meinolf Sellmann
Designing Fast Absorbing Markov Chains	Stefano Ermon, Carla Gomes, Ashish Sabharwal, Bart Selman
Simpler Bounded Suboptimal Search	Matthew Hatem, Wheeler Ruml
Elimination Ordering in Lifted First-Order Probabilistic Inference	Seyed Mehran Kazemi, David Poole
Exponential Deepening A* for Real-Time Agent-Centered Search	Guni Sharon, Ariel Felner, Nathan Sturtevant
Identifying Hierarchies for Fast Optimal Search	Tansel Uras, Sven Koenig
Worst-Case Solution Quality Analysis When Not Re-Expanding Nodes in Best-First Search	Richard Anthony Valenzano, Nathan R. Sturtevant, Jonathan Schaeffer
Sparse Learning for Stochastic Composite Optimization	Weizhong Zhang, Lijun Zhang, Yao Hu, Rong Jin, Deng Cai, Xiaofei He
Acquiring Commonsense Knowledge for Sentiment Analysis through Human Computation	Marina Boia, Claudiu Cristian Musat, Boi Faltings
Signals in the Silence: Models of Implicit Feedback in a Recommendation System for Crowdsourcing	Christopher H Lin, Ece Kamar, Eric Horvitz
Leveraging Fee-Based, Imperfect Advisors in Human-Agent Games of Trust	Cody Buntain, Amos Azaria, Sarit Kraus
Can Agent Development Affect Developer's Strategy?	Avshalom Elmalech, David Sarne, Noa Agmon
Ordering Effects and Belief Adjustment in the Use of Comparison Shopping Agents	Chen Hajaj, Noam Hazon, David Sarne
A Strategy-Aware Technique for Learning Behaviors from Discrete Human Feedback	Robert Tyler Loftin, James MacGlashan, Bei Peng, Matthew E. Taylor, Michael L. Littman, Jeff Huang, David L. Roberts
Dramatis: A Computational Model of Suspense	Brian O'Neill, Mark Riedl
Sketch Recognition with Natural Correction and Editing	Jie Wu, Changhu Wang, Liqing Zhang, Yong Rui
Role-Aware Conformity Modeling and Analysis in Social Networks	Jing Zhang, Jie Tang, Honglei Zhuang, Cane Wing-Ki Leung, Juanzi Li
Managing Change in Graph-Structured Data Using Description Logics	Shqiponja Ahmetaj, Diego Calvanese, Magdalena Ortiz, Mantas Simkus
The Computational Complexity of Structure-Based Causality	Gadi Aleksandrowicz, Hana Chockler, Joseph Y. Halpern, Alexander Ivrii
Pathway Specification and Comparative Queries: A High Level Language with Petri Net Semantics	Saadat Anwar, Chitta Baral
PREGO: An Action Language for Belief-Based Cognitive Robotics in Continuous Domains	Vaishak Belle, Hector Levesque
Querying Inconsistent Description Logic Knowledge Bases under Preferred Repair Semantics	Meghyn Bienvenu, Camille Bourgaux, François Goasdoué
Capturing Relational Schemas and Functional Dependencies in RDFS	Diego Calvanese, Wolfgang Fischl, Reinhard Pichler, Emanuel Sallinger, Mantas Simkus
Exploring the Boundaries of Decidable Verification of Non-Terminating Golog Programs	Jens Classen, Martin Liebenberg, Gerhard Lakemeyer, Benjamin Zarriess
Data Quality in Ontology-based Data Access: The Case of Consistency	Marco Console, Maurizio Lenzerini
Reasoning on LTL on Finite Traces: Insensitivity to Infiniteness	Giuseppe De Giacomo, Riccardo De Masellis, Marco Montali
A Tractable Approach to ABox Abduction over Description Logic Ontologies	Jianfeng Du, Kewen Wang, Yi-Dong Shen
Exploiting Support Sets for Answer Set Programs with External Evaluations	Thomas Eiter, Michael Fink, Christoph Redl, Daria Stepanova
A Knowledge Compilation Map for Ordered Real-Valued Decision Diagrams	Hélène Fargier, Pierre Marquis, Alexandre Niveau, Nicolas Schmidt
The Complexity of Reasoning with FODD and GFODD	Benjamin J. Hescott, Roni Khardon
Elementary Loops Revisited	Jianmin Ji, Hai Wan, Peng Xiao, Ziwei Huo, Zhanhao Xiao
A Constructive Argumentation Framework	Souhila Kaci, Yakoub Salhi
Datalog Rewritability of Disjunctive Datalog Programs and its Applications to Ontology Reasoning	Mark Kaminski, Yavor Nenov, Bernardo Cuenca Grau
Qualitative Reasoning with Modelica Models	Matthew Evans Klenk, Johan de Kleer, Daniel Bobrow, Bill Janssen
A Parameterized Complexity Analysis of Generalized CP-Nets	Martin Kronegger, Martin Lackner, Andreas Pfandler, Reinhard Pichler
The Most Uncreative Examinee: A First Step toward Wide Coverage Natural Language Math Problem Solving	Takuya Matsuzaki, Hidenao Iwane, Hirokazu Anai, Noriko H Arai
Computing General First-Order Parallel and Prioritized Circumscription	Hai Wan, Zhanhao Xiao, Zhenfeng Yuan, Heng Zhang, Yan Zhang
Knowledge Graph Embedding by Translating on Hyperplanes	Zhen Wang, Jianwen Zhang, Jianlin Feng, Zheng Chen
Abduction Framework for Repairing Incomplete EL Ontologies: Complexity Results and Algorithms	Fang Wei-Kleiner, Zlatan Dragisic, Patrick Lambrix
Local-to-Global Consistency Implies Tractability of Abduction	Michal Wrona
Using Model-Based Diagnosis to Improve Software Testing	Tom Zamir, Roni Tzvi Stern, Meir Kalech
Pay-As-You-Go OWL Query Answering Using a Triple Store	Yujiao Zhou, Yavor Nenov, Bernardo Cuenca Grau, Ian Horrocks
Contraction and Revision over DL-Lite TBoxes	Zhiqiang Zhuang, Zhe Wang, Kewen Wang, Guilin Qi
A Spatially Sensitive Kernel to Predict Cognitive Performance from Short-Term Changes in Neural Structure	M. Hidayath Ansari, Michael H. Coen, Barbara B Bendlin, Mark A Sager, Sterling C Johnson
Accurate Household Occupant Behavior Modeling Based on Data Mining Techniques	Márcia L. Baptista, Anjie Fang, Helmut Prendinger, Rui Prada, Yohei Yamaguchi
A Convex Formulation for Semi-Supervised Multi-Label Feature Selection	Xiaojun Chang, Feiping Nie, Yi Yang, Heng Huang
Predicting Postoperative Atrial Fibrillation from Independent ECG Components	Chih-Chun Chia, James Blum, Zahi Karam, Satinder Singh, Zeeshan Syed
Online Portfolio Selection with Group Sparsity	Puja Das, Nicholas Johnson, Arindam Banerjee
Latent Low-Rank Transfer Subspace Learning for Missing Modality Recognition	Zhengming Ding, Shao Ming, Yun Fu
On the Challenges of Physical Implementations of RBMs	Vincent Dumoulin, Ian J Goodfellow, Aaron Courville, Yoshua Bengio
SOML: Sparse Online Metric Learning with Application to Image Retrieval	Xingyu Gao, Steven C.H. Hoi, Yongdong Zhang, Ji Wan, Jintao Li
Calibration-Free BCI Based Control	Jonathan Grizou, Iñaki Iturrate, Luis Montesano, Pierre-Yves Oudeyer, Manuel Lopes
User Intent Identification from Online Discussions Using a Joint Aspect-Action Topic Model	Ghasem Heyrani Nobari, Chua Tat-Seng
Low-Rank Tensor Learning with Discriminant Analysis for Action Classification and Image Recovery	Chengcheng Jia, Guoqiang Zhong, Yun Fu
Ranking Tweets by Labeled and Collaboratively Selected Pairs with Transitive Closure	Shenghua Liu, Xueqi Cheng, Fangtao Li
Automatic Construction and Natural-Language Description of Nonparametric Regression Models	James Robert Lloyd, David Duvenaud, Roger Grosse, Joshua Tenenbaum, Zoubin Ghahramani
Proximal Iteratively Reweighted Algorithm with Multiple Splitting for Nonconvex Sparsity Optimization	Canyi Lu, Yunchao Wei, Zhouchen Lin, Shuicheng Yan
Direct Semantic Analysis for Social Image Classification	Zhiwu Lu, Liwei Wang, Ji-Rong Wen
Discovering Better AAAI Keywords via Clustering with Community-Sourced Constraints	Kelly H. Moran, Byron C. Wallace, Carla E. Brodley
Learning Latent Engagement Patterns of Students in Online Courses	Arti Ramesh, Dan Goldwasser, Bert Huang, Hal Daume III, Lise Getoor
Generalized Higher-Order Tensor Decomposition via Parallel ADMM	Fanhua Shang, Yuanyuan Liu, James Cheng
Doubly Regularized Portfolio with Risk Minimization	Weiwei Shen, Jun Wang, Shiqian Ma
Learning Deep Representations for Graph Clustering	Fei Tian, Bin Gao, Qing Cui, Enhong Chen, Tie-Yan Liu
Agent Behavior Prediction and Its Generalization Analysis	Fei Tian, Haifang Li, Wei Chen, Tao Qin, Enhong Chen, Tie-Yan Liu
Evaluating Trauma Patients: Addressing Missing Covariates with Joint Optimization	Alex Van Esbroeck, Satinder Singh, Ilan Rubinfeld, Zeeshan Syed
Identifying Differences in Physician Communication Styles with a Log-Linear Transition Component Model	Byron C Wallace, Issa J Dahabreh, Thomas A Trikalinos, Michael Barton Laws, Ira Wilson, Eugene Charniak
Robust Distance Metric Learning in the Presence of Label Noise	Dong Wang, Xiaoyang Tan
Globally and Locally Consistent Unsupervised Projection	Hua Wang, Feiping Nie, Heng Huang
Adaptive Knowledge Transfer for Multiple Instance Learning in Image Classification	Qifan Wang, Lingyun Ruan, Luo Si
Privacy and Regression Model Preserved Learning	Jinfeng Yi, Jun Wang, Rong Jin
Decomposing Activities of Daily Living to Discover Routine Clusters	Onur Yürüten, Jiyong Zhang, Pearl Pu
Feature Selection at the Discrete Limit	Miao Zhang, Chris Ding, Ya Zhang, Feiping Nie
Hybrid Singular Value Thresholding for Tensor Completion	Xiaoqin Zhang, Zhengyuan Zhou, Di Wang, Yi Ma
Sequential Click Prediction for Sponsored Search with Recurrent Neural Networks	Yuyu Zhang, Hanjun Dai, Chang Xu, Jun Feng, Taifeng Wang, Jiang Bian, Bin Wang, Tie-Yan Liu
Accurate Integration of Aerosol Predictions by Smoothing on a Manifold	Shuai Zheng, James Kwok
Dynamic Multi-Agent Task Allocation with Spatial and Temporal Constraints	Sofia Amador, Steven Okamoto, Roie Zivan
Robust Winners and Winner Determination Policies under Candidate Uncertainty	Craig Boutilier, Jérôme Lang, Joel Oren, Héctor Palacios
Prices Matter for the Parameterized Complexity of Shift Bribery	Robert Bredereck, Jiehua Chen, Piotr Faliszewski, André Nichterlein, Rolf Niedermeier
The Computational Rise and Fall of Fairness	John P Dickerson, Jonathan Goldman, Jeremy Karp, Ariel D Procaccia, Tuomas Sandholm
Multi-Organ Exchange: The Whole Is Greater than the Sum of its Parts	John P Dickerson, Tuomas Sandholm
On Computing Optimal Strategies in Open List Proportional Representation: The Two Parties Case	Ning Ding, Fangzhen Lin
Symbolic Model Checking Epistemic Strategy Logic	Xiaowei Huang, Ron van der Meyden
Internally Stable Matchings and Exchanges	Yicheng Liu, Pingzhong Tang, Wenyi Fang
Congestion Games for V2G-Enabled EV Charging	Benny Lutati, Vadim Levit, Tal Grinshpoun, Amnon Meisels
Decentralized Multi-Agent Reinforcement Learning in Average-Reward Dynamic DCOPs	Duc Thien Nguyen, William Yeoh, Hoong Chuin Lau, Shlomo Zilberstein, Chongjie Zhang
Online (Budgeted) Social Choice	Joel Oren, Brendan Lucier
A Game-Theoretic Analysis of Catalog Optimization	Joel Oren, Nina Narodytska, Craig Boutilier
Theory of Cooperation in Complex Social Networks	Bijan Ranjbar-Sahraei, Haitham Bou Ammar, Daan Bloembergen, Karl Tuyls, Gerhard Weiss
Multiagent Metareasoning through Organizational Design	Jason Sleight, Edmund H. Durfee
Give a Hard Problem to a Diverse Team: Exploring Large Action Spaces	Leandro Soriano Marcolino, Haifeng Xu, Albert Xin Jiang, Milind Tambe, Emma Bowring
Regret-Based Multi-Agent Coordination with Uncertain Task Rewards	Feng Wu, Nicholas R. Jennings
Solving Zero-Sum Security Games in Discretized Spatio-Temporal Domains	Haifeng Xu, Fei Fang, Albert Xin Jiang, Vincent Conitzer, Shaddin Dughmi, Milind Tambe
Scalable Complex Contract Negotiation with Structured Search and Agenda Management	Xiaoqin Shelley Zhang, Mark Klein, Ivan Marsa-Maestre
SenticNet 3: A Common and Common-Sense Knowledge Base for Cognition-Driven Sentiment Analysis	Erik Cambria, Daniel Olsher, Dheeraj Rajagopal
Joint Morphological Generation and Syntactic Linearization	Linfeng Song, Yue Zhang, Kai Song, Qun Liu
Improving Domain-independent Cloud-Based Speech Recognition with Domain-Dependent Phonetic Post-Processing	Johannes Twiefel, Timo Baumann, Stefan Heinrich, Stefan Wermter
Adaptive Multi-Compositionality for Recursive Neural Models with Applications to Sentiment Analysis	Li Dong, Furu Wei, Ming Zhou, Ke Xu
Collaborative Models for Referring Expression Generation in Situated Dialogue	Rui Fang, Malcolm Doering, Joyce Y. Chai
Prediction of Helpful Reviews Using Emotions Extraction	Lionel Martin, Pearl Pu
Unsupervised Alignment of Natural Language Instructions with Video Segments	Iftekhar Naim, Young Chol Song, Qiguang Liu, Henry Kautz, Jiebo Luo, Daniel Gildea
Learning Scripts as Hidden Markov Models	John Walker Orr, Prasad Tadepalli, Janardhan Rao Doppa, Xiaoli Fern, Thomas G. Dietterich
Learning Word Representation Considering Proximity and Ambiguity	Lin Qiu, Yong Cao, Zaiqing Nie, Yong Yu, Yong Rui
On Dataless Hierarchical Text Classification	Yangqiu Song, Dan Roth
Learning Concept Embeddings for Query Expansion by Quantum Entropy Minimization	Alessandro Sordoni, Yoshua Bengio, Jian-Yun Nie
Fused Feature Representation Discovery for High-Dimensional and Sparse Data	Jun Suzuki, Masaaki Nagata
Instance-Based Domain Adaptation in NLP via In-Target-Domain Logistic Approximation	Rui Xia, Jianfei Yu, Feng Xu, Shumei Wang
Semi-Supervised Matrix Completion for Cross-Lingual Text Classification	Min Xiao, Yuhong Guo
Chinese Overt Pronoun Resolution: A Bilingual Approach	Chen Chen, Vincent Ng
Chinese Zero Pronoun Resolution: An Unsupervised Approach Combining Ranking and Integer Linear Programming	Chen Chen, Vincent Ng
Extracting Keyphrases from Research Papers Using Citation Networks	Sujatha Das Gollapalli, Cornelia Caragea
SUIT: A Supervised User-Item Based Topic Model for Sentiment Analysis	Fangtao Li, Sheng Wang, Shenghua Liu, Ming Zhang
Lifetime Lexical Variation in Social Media	Lizi Liao, Jing Jiang, Ying Ding, Heyan Huang, Ee-Peng Lim
Detecting Information-Dense Texts in Multiple News Domains	Yinfei Yang, Ani Nenkova
Mind the Gap: Machine Translation by Minimizing the Semantic Gap in Embedding Space	Jiajun Zhang, Shujie Liu, Mu Li, Ming Zhou, Chengqing Zong
Supervised Transfer Sparse Coding	Maruan Al-Shedivat, Jim Jing-Yan Wang, Majed Alzahrani, Jianhua Z. Huang, Xin Gao
Active Learning with Model Selection	Alnur Ali, Rich Caruana, Ashish Kapoor
Multilabel Classification with Label Correlations and Missing Labels	Wei Bi, James T Kwok
Combining Multiple Correlated Reward and Shaping Signals by Measuring Confidence	Tim Brys, Ann Nowé, Daniel Kudenko, Matthew E. Taylor
Optimal Neighborhood Preserving Visualization by Maximum Satisfiability	Kerstin Bunte, Matti Järvisalo, Jeremias Berg, Petri Myllymäki, Jaakko Peltonen, Samuel Kaski
PAC Rank Elicitation through Adaptive Sampling of Stochastic Pairwise Preferences	Róbert Busa-Fekete, Balázs Szörényi, Eyke Hüllermeier
Manifold Spanning Graphs	CJ Carey, Sridhar Mahadevan
LASS: A Simple Assignment Model with Laplacian Smoothing	Miguel Angel Carreira-Perpinan, Weiran Wang
Distribution-Aware Sampling and Weighted Model Counting for SAT	Supratik Chakraborty, Daniel J. Fremont, Kuldeep S. Meel, Sanjit A. Seshia, Moshe Y. Vardi
Dynamic Bayesian Probabilistic Matrix Factorization	Sotirios Chatzis
Echo-State Conditional Restricted Boltzmann Machines	Sotirios Chatzis
A Local Non-Negative Pursuit Method for Intrinsic Manifold Structure Preservation	Dongdong Chen, Jian Cheng Lv, Zhang Yi
Dropout Training for Support Vector Machines	Ning Chen, Jun Zhu, Jianfei Chen, Bo Zhang
Learning with Augmented Class by Exploiting Unlabeled Data	Qing Da, Yang Yu, Zhi-Hua Zhou
Natural Temporal Difference Learning	William Dabney, Philip Thomas
Learning the Structure of Probabilistic Graphical Models with an Extended Cascading Indian Buffet Process	Patrick Dallaire, Philippe Giguère, Brahim Chaib-draa
Finding Median Point-Set Using Earth Mover's Distance	Hu Ding, Jinhui Xu
Non-Linear Label Ranking for Large-Scale Prediction of Long-Term User Interests	Nemanja Djuric, Mihajlo Grbovic, Vladan Radosavljevic, Narayan Bhamidipati, Slobodan Vucetic
HC-Search for Multi-Label Prediction: An Empirical Study	Janardhan Rao Doppa, Jun Yu, Chao Ma, Alan Fern, Prasad Tadepalli
Learning Instance Concepts from Multiple-Instance Data with Bags as Distributions	Gary Doran, Soumya Ray
Active Learning for Crowdsourcing Using Knowledge Transfer	Meng Fang, Jie Yin, Dacheng Tao
Large-Scale Optimistic Adaptive Submodularity	Victor Gabillon, Branislav Kveton, Zheng Wen, Brian Eriksson, S. Muthukrishnan
Coactive Learning for Locally Optimal Problem Solving	Robby Goetschalckx, Alan Fern, Prasad Tadepalli
Kernelized Bayesian Transfer Learning	Mehmet Gönen, Adam A. Margolin
ReLISH: Reliable Label Inference via Smoothness Hypothesis	Chen Gong, Dacheng Tao, Keren Fu, Jie Yang
Signed Laplacian Embedding for Supervised Dimension Reduction	Chen Gong, Dacheng Tao, Jie Yang, Keren Fu
Encoding Tree Sparsity in Multi-Task Learning: A Probabilistic Framework	Lei Han, Yu Zhang, Guojie Song, Kunqing Xie
Deep Modeling of Group Preferences for Group-Based Recommendation	Liang Hu, Jian Cao, Guandong Xu, Longbing Cao, Zhiping Gu, Wei Cao
Fast Multi-Instance Multi-Label Learning	Sheng-Jun Huang, Wei Gao, Zhi-Hua Zhou
Adaptation-Guided Case Base Maintenance	Vahid Jalali, David Leake
Intra-View and Inter-View Supervised Correlation Analysis for Multi-View Feature Learning	Xiao-Yuan Jing, Rui-Min Hu, Yang-Ping Zhu, Shan-Shan Wu, Chao Liang, Jing-Yu Yang
Imitation Learning with Demonstrations and Shaping Rewards	Kshitij Judah, Alan Paul Fern, Prasad Tadepalli, Robby Goetschalckx
Monte Carlo Filtering Using Kernel Embedding of Distributions	Motonobu Kanagawa, Yu Nishiyama, Arthur Gretton, Kenji Fukumizu
Power Iterated Color Refinement	Kristian Kersting, Martin Mladenov, Roman Garnett, Martin Grohe
Spectral Thompson Sampling	Tomáš Kocák, Michal Valko, Rémi Munos, Shipra Agrawal
Non-Convex Feature Learning via L_{p, inf} Operator	Deguang Kong, Chris Ding
Pairwise-Covariance Linear Discriminant Analysis	Deguang Kong, Chris Ding
Constructing Symbolic Representations for High-Level Planning	George Konidaris, Leslie Kaelbling, Tomas Lozano-Perez
Feature-Cost Sensitive Learning with Submodular Trees of Classifiers	Matt Kusner, Wenlin Chen, Quan Zhou, Zhixiang (Eddie) Xu, Kilian Weinberger, Yixin Chen
Scalable Sparse Covariance Estimation via Self-Concordance	Anastasios Kyrillidis, Rabeeh Karimi Mahabadi, Quoc Tran Dinh, Volkan Cevher
Wormhole Hamiltonian Monte Carlo	Shiwei Lan, Jeffrey Streets, Babak Shahbaba
Manifold Learning for Jointly Modeling Topic and Visualization	Tuan M. V. Le, Hady W. Lauw
Partial Multi-View Clustering	Shao-Yuan Li, Yuan Jiang, Zhi-Hua Zhou
Sample-Adaptive Multiple Kernel Learning	Xinwang Liu, Lei Wang, Jian Zhang, Jianping Yin
Pre-Trained Multi-View Word Embedding Using Two-Side Neural Network	Yong Luo, Jian Tang, Jun Yan, Chao Xu, Zheng Chen
Convex Co-embedding	Farzaneh Mirzazadeh, Yuhong Guo, Dale Schuurmans
Mixing-Time Regularized Policy Gradient	Tetsuro Morimura, Takayuki Osogami, Tomoyuki Shirai
Semantic Data Representation for Improving Tensor Factorization	Makoto Nakatsuji, Yasuhiro Fujiwara, Hiroyuki Toda, Hiroshi Sawada, Jin Zheng, James Alexander Hendler
Labeling Complicated Objects: Multi-View Multi-Instance Multi-Label Learning	Cam-Tu Nguyen, Xiaoliang Wang, Jing Liu, Zhi-Hua Zhou
Online and Stochastic Learning with a Human Cognitive Bias	Hidekazu Oiwa, Hiroshi Nakagawa
Robust Non-Negative Dictionary Learning	Qihe Pan, Deguang Kong, Chris Ding, Bin Luo
Evolutionary Dynamics of Q-Learning over the Sequence Form	Fabio Panozzo, Nicola Gatti, Marcello Restelli
Bagging by Design (on the Suboptimality of Bagging)	Periklis Papakonstantinou, Jia Xu, Zhu Cao
Anytime Active Learning	Maria Eugenia Ramirez-Loaiza, Aron Culotta, Mustafa Bilgic
On Boosting Sparse Parities	Lev Reyzin
Online Multi-Task Learning via Sparse Dictionary Optimization	Paul Ruvolo, Eric Eaton
A Hybrid Grammar-Based Approach for Learning and Recognizing Natural Hand Gestures	Amir Sadeghipour, Stefan Kopp
Sparse Compositional Metric Learning	Yuan Shi, Aurélien Bellet, Fei Sha
Locality Preserving Projection for Domain Adaptation with Multi-Objective Learning	Le Shu, Tianyang Ma, Longin Jan Latecki
Reconsidering Mutual Information Based Feature Selection: A Statistical Significance View	Nguyen Xuan Vinh, Jeffrey Chan, James Bailey
Cross-Domain Metric Learning Based on Information Theory	Hao Wang, Wei Wang, Chen Zhang, Fanjiang Xu
Improving Semi-Supervised Target Alignment via Label-Aware Base Kernels	Qiaojun Wang, Kai Zhang, Guofei Jiang, Ivan Maric
Exact Subspace Clustering in Linear Time	Shusen Wang, Bojun Tu, Congfu Xu, Zhihua Zhang
Using The Matrix Ridge Approximation to Speedup Determinantal Point Processes Sampling Algorithms	Shusen Wang, Chao Zhang, Hui Qian, Zhihua Zhang
The Role of Dimensionality Reduction in Classification	Weiran Wang, Miguel Angel Carreira-Perpinan
Small-Variance Asymptotics for Dirichlet Process Mixtures of SVMs	Yining Wang, Jun Zhu
Learning Relative Similarity by Stochastic Dual Coordinate Ascent	Pengcheng Wu, Yi Ding, Peilin Zhao, Chunyan Miao, Steven C. H. Hoi
Robust Multi-View Spectral Clustering via Low-Rank and Sparse Decomposition	Rongkai Xia, Yan Pan, Lei Du, Jian Yin
Supervised Hashing for Image Retrieval via Image Representation Learning	Rongkai Xia, Yan Pan, Hanjiang Lai, Cong Liu, Shuicheng Yan
Efficient Generalized Fused Lasso and its Application to the Diagnosis of Alzheimer’s Disease	Bo Xin, Yoshinobu Kawahara, Yizhou Wang, Wen Gao
Online Classification Using a Voted RDA Method	Tianbing Xu, Jianfeng Gao, Lin Xiao, Amelia C. Regan
Large-Scale Supervised Multimodal Hashing with Semantic Correlation Maximization	Dongqing Zhang, Wu-Jun Li
Multi-Instance Learning with Distribution Change	Wei-Jia Zhang, Zhi-Hua Zhou
Novel Density-Based Clustering Algorithms for Uncertain Data	Xianchao Zhang, Han Liu, Xiaotong Zhang, Xinyue Liu
Robust Bayesian Inverse Reinforcement Learning with Sparse Behavior Noise	Jiangchuan Zheng, Siyuan Liu, Lionel M. Ni
Gradient Descent with Proximal Average for Nonconvex and Composite Regularization	Wenliang Zhong, James T. Kwok
Hybrid Heterogeneous Transfer Learning through Deep Learning	Joey Tianyi Zhou, Sinno Jialin Pan, Ivor W. Tsang, Yan Yan
Oversubscription Planning: Complexity and Compilability	Meysam Aghighi, Peter Jonsson
Planning as Model Checking in Hybrid Domains	Sergiy Bogomolov, Daniele Magazzeni, Andreas Podelski, Martin Wehrle
Flexible and Scalable Partially Observable Planning with Linear Translations	Blai Bonet, Hector Geffner
Using Timed Game Automata to Synthesize Execution Strategies for Simple Temporal Networks with Uncertainty	Alessandro Cimatti, Luke Hunsberger, Andrea Micheli, Marco Roveri
Scheduling for Transfers in Pickup and Delivery Problems with Very Large Neighborhood Search	Brian Coltin, Manuela Veloso
Structured Possibilistic Planning Using Decision Diagrams	Nicolas Drougard, Florent Teichteil-Königsbuch, Jean-Loup Farges, Didier Dubois
Chance-Constrained Probabilistic Simple Temporal Problems	Cheng Fang, Peng Yu, Brian C. Williams
Solving the Traveling Tournament Problem by Packing Three-Vertex Paths	Marc Goerigk, Richard Hoshino, Ken-ichi Kawarabayashi, Stephan Westphal
Delivering Guaranteed Display Ads under Reach and Frequency Requirements	Ali Hojjat, John Turner, Suleyman Cetintas, Jian Yang
Solving Uncertain MDPs by Reusing State Information and Plans	Ping Hou, William Yeoh, Tran Cao Son
Grandpa Hates Robots - Interaction Constraints for Planning in Inhabited Environments	Uwe Koeckemann, Federico Pecora, Lars Karlsson
Backdoors to Planning	Martin Kronegger, Sebastian Ordyniak, Andreas Pfandler
A Simple Polynomial-Time Randomized Distributed Algorithm for Connected Row Convex Constraints	T. K. Satish Kumar, Duc Thien Nguyen, William Yeoh, Sven Koenig
Symbolic Domain Predictive Control	Johannes Löhr, Martin Wehrle, Maria Fox, Bernhard Nebel
Computing Contingent Plans via Fully Observable Non-Deterministic Planning	Christian Muise, Vaishak Belle, Sheila A. McIlraith
A Scheduler for Actions with Iterated Durations	James G Paterson, Eric Timmons, Brian C Williams
Parametrized Families of Hard Planning Problems from Phase Transitions	Eleanor Rieffel, Davide Venturelli, Minh Do, Itay Hen, Jeremy Frank
Cost-Based Query Optimization via AI Planning	Nathan Robinson, Sheila McIlraith, David Toman
Efficiently Implementing GOLOG with Answer Set Programming	Malcolm Ryan
Generalized Label Reduction for Merge-and-Shrink Heuristics	Silvan Sievers, Martin Wehrle, Malte Helmert
Saturated Path-Constrained MDP: Planning under Uncertainty and Deterministic Model-Checking Constraints	Jonathan Sprauel, Andrey Kolobov, Florent Teichteil-Königsbuch
A Relevance-Based Compilation Method for Conformant Probabilistic Planning	Ran Taig, Ronen I. Brafman
Optimal Decoupling in Linear Constraint Systems	Cees Witteveen, Michel Wilson, Tomas Klos
Adding Local Exploration to Greedy Best-First Search in Satisficing Planning	Fan Xie, Martin Müller, Robert Holte
Type-Based Exploration with Multiple Search Queues for Satisficing Planning	Fan Xie, Martin Müller, Robert Holte, Tatsuya Imai
Lifting Relational MAP-LPs Using Cluster Signatures	Udi Apsel, Kristian Kersting, Martin Mladenov
Recovering from Selection Bias in Causal and Statistical Inference	Elias Bareinboim, Jin Tian, Judea Pearl
Tree-Based On-Line Reinforcement Learning	Andre M. S. Barreto
Testable Implications of Linear Structural Equation Models	Bryant Chen, Jin Tian, Judea Pearl
Finding the k-best Equivalence Classes of Bayesian Network Structures for Model Averaging	Yetian Chen, Jin Tian
Tightening Bounds for Bayesian Network Structure Learning	Xiannian Fan, Changhe Yuan, Brandon Malone
State Aggregation in Monte Carlo Tree Search	Jesse Hostetler, Alan Fern, Tom Dietterich
Relational One-Class Classification: A Non-Parametric Approach	Tushar Khot, Sriraam Natarajan, Jude Shavlik
Predicting the Hardness of Learning Bayesian Networks	Brandon Malone, Kustaa Kangas, Matti Jarvisalo, Mikko Koivisto, Petri Myllymaki
Tractability through Exchangeability: A New Perspective on Efficient Probabilistic Inference	Mathias Niepert, Guy Van den Broeck
R2: An Efficient MCMC Sampler for Probabilistic Programs	Aditya Nori, Chung-Kil Hur, Sriram Rajamani, Selva Samuel
An Adversarial Interpretation of Information-Theoretic Bounded Rationality	Pedro A. Ortega, Daniel D. Lee
Explanation-Based Approximate Weighted Model Counting for Probabilistic Logics	Joris Renkens, Angelika Kimmig, Guy Van den Broeck, Luc De Raedt
Approximate Lifting Techniques for Belief Propagation	Parag Singla, Aniruddh Nath, Pedro M. Domingos
Decentralized Stochastic Planning with Anonymity in Interactions	Pradeep Varakantham, Yossiri Adulyasak, Patrick Jaillet
Point-Based POMDP Solving with Factored Value Function Approximation	Tiago Veiga, Matthijs Spaan, Pedro Lima
Efficient Optimization for Autonomous Robotic Manipulation of Natural Objects	Abdeslam Boularias, James Andrew Bagnell, Anthony Stentz
A Framework for Task Planning in Heterogeneous Multi Robot Systems Based on Robot Capabilities	Jennifer Buehler, Maurice Pagnucco
Generalizing Policy Advice with Gaussian Process Bandits for Dynamic Skill Improvement	Jared Glover, Charlotte Zhu
Minimising Undesired Task Costs in Multi-Robot Task Allocation Problems with In-Schedule Dependencies	Bradford Heap, Maurice Pagnucco
Optimal and Efficient Stochastic Motion Planning in Partially-Known Environments	Ryan J Luna, Morteza Lahijanian, Mark Moll, Lydia E Kavraki
Learning from Unscripted Deictic Gesture and Language for Human-Robot Interactions	Cynthia Matuszek, Liefeng Bo, Luke Zettlemoyer, Dieter Fox
Robust Visual Robot Localization Across Seasons Using Network Flows	Tayyab Naseer, Luciano Spinello, Wolfram Burgard, Cyrill Stachniss
Schedule-Based Robotic Search for Multiple Residents in a Retirement Home Environment	Markus Sebastian Schwenk, Tiago Stegun Vaquero, Goldie Nejat, Kai O. Arras
Qualitative Planning with Quantitative Constraints for Online Learning of Robotic Behaviours	Timothy Wiley, Claude Sammut, Ivan Bratko
GP-Localize: Persistent Mobile Robot Localization Using Online Sparse Gaussian Process Observation Model	Nuo Xu, Kian Hsiang Low, Jie Chen, Keng Kiat Lim, Etkin Baris Ozgul
MaxSAT by Improved Instance-Specific Algorithm Configuration	Carlos Ansotegui, Yuri Malitsky, Meinolf Sellmann
Adaptive Singleton-Based Consistencies	Amine Balafrej, Christian Bessiere, El Houssine Bouyakhf, Gilles Trombettoni
Non-Restarting SAT Solvers with Simple Preprocessing Can Efficiently Simulate Resolution	Paul Beame, Ashish Sabharwal
Propagating Regular Counting Constraints	Nicolas Beldiceanu, Pierre Flener, Justin Pearson, Pascal Van Hentenryck
Tailoring Local Search for Partial MaxSAT	Shaowei Cai, Chuan Luo, John Thornton, Kaile Su
Q-Intersection Algorithms for Constraint-Based Robust Parameter Estimation	Clement Carbonnel, Gilles Trombettoni, Philippe Vismara, Gilles Chabert
Linear-Time Filtering Algorithms for the Disjunctive Constraint	Hamed Fahimi, Claude-Guy Quimper
Diagnosing Analogue Linear Systems Using Dynamic Topological Reconfiguration	Alexander Feldman, Gregory Provan
Backdoors into Heterogeneous Classes of SAT and CSP	Serge Gaspers, Neeldhara Misra, Sebastian Ordyniak, Stefan Szeider, Stanislav Zivny
A Reasoner for the RCC-5 and RCC-8 Calculi Extended with Constants	Stella Giannakopoulou, Charalampos Nikolaou, Manolis Koubarakis
An Experimentally Efficient Method for (MSS, CoMSS) Partitioning	Eric Grégoire, Jean-Marie Lagniez, Bertrand Mazure
A Support-Based Algorithm for the Bi-Objective Pareto Constraint	Renaud Hartert, Pierre Schaus
DJAO: A Communication-Constrained DCOP Algorithm that Combines Features of ADOPT and Action-GDL	Yoonheui Kim, Victor Lesser
Preprocessing for Propositional Model Counting	Jean-Marie Lagniez, Pierre Marquis
Boosting SBDS for Partial Symmetry Breaking in Constraint Programming	Jimmy H.M. Lee, Zichen Zhu
Double Configuration Checking in Stochastic Local Search for Satisfiability	Chuan Luo, Shaowei Cai, Wei Wu, Kaile Su
A Propagator Design Framework for Constraints over Sequences	Jean-Noel Monette, Pierre Flener, Justin Pearson
Maximum Satisfiability Using Core-Guided MaxSAT Resolution	Nina Narodytska, Fahiem Bacchus
Fast Consistency Checking of Very Large Real-World RCC-8 Constraint Networks Using Graph Partitioning	Charalampos Nikolaou, Manolis Koubarakis
Avoiding Plagiarism in Markov Sequence Generation	Alexandre Papadopoulos, Pierre Roy, François Pachet
Cached Iterative Weakening for Optimal Multi-Way Number Partitioning	Ethan L Schreiber, Richard E Korf
Exploiting Competition Relationship for Robust Visual Recognition	Liang Du, Haibin Ling
Towards Topological-Transformation Robust Shape Comparison: A Sparse Representation Based Manifold Embedding Approach	Longwen Gao, Shuigeng Zhou
Grounding Acoustic Echoes in Single View Geometry Estimation	Muhammad Wajahat Hussain, Javier Civera, Luis Montano
Similarity-Preserving Binary Signature for Linear Subspaces	Jianqiu Ji, Jianmin Li, Shuicheng Yan, Qi Tian, Bo Zhang
Deep Salience: Visual Salience Modeling via Deep Belief Propagation	Richard Jiang, Danny Crookes
Locality-Constrained Low-Rank Coding for Image Classification	Ziheng Jiang, Ping Guo, Lihong Peng
Uncorrelated Multi-View Discrimination Dictionary Learning for Recognition	Xiao-Yuan Jing, Rui-Min Hu, Fei Wu, Xi-Lin Chen, Qian Liu, Yong-Fang Yao
Learning to Recognize Novel Objects in One Shot through Human-Robot Interactions in Natural Language Dialogues	Evan A. Krause, Michael Zillich, Thomas Williams, Matthias Scheutz
Sub-Selective Quantization for Large-Scale Image Search	Yeqing Li, Chen Chen, Wei Liu, Junzhou Huang
Learning Low-Rank Representations with Classwise Block-Diagonal Structure for Robust Face Recognition	Yong Li, Jing Liu, Zechao Li, Yangmuzi Zhang, Hanqing Lu, Songde Ma
Efficient Object Detection via Adaptive Online Selection of Sensor-Array Elements	Matthai Philipose
On Hair Recognition in the Wild by Machine	Joseph Roth, Xiaoming Liu
Diagram Understanding in Geometry Questions	Min Joon Seo, Hannaneh Hajishirzi, Ali Farhadi, Oren Etzioni
A Generalized Genetic Algorithm-Based Solver for Very Large Jigsaw Puzzles of Complex Types	Dror Sholomon, Omid E. David, Nathan S. Netanyahu
Low-Rank Tensor Completion with Spatio-Temporal Consistency	Hua Wang, Feiping Nie, Heng Huang
Semantic Graph Construction for Weakly-Supervised Image Parsing	Wenxuan Xie, Yuxin Peng, Jianguo Xiao
Latent Domains Modeling for Visual Domain Adaptation	Caiming Xiong, Scott McCloskey, Shao-Hang Hsieh, Jason J. Corso
Semantic Segmentation Using Multiple Graphs with Block-Diagonal Constraints	Ke Zhang, Wei Zhang, Sheng Zeng, Xiangyang Xue
Locality Preserving Hashing	Kang Zhao, Hongtao Lu, Jincheng Mei
